#          B
# #########
# #       # 
# # ##### # 
#   #     #
### # #####
A   #